100 100 100 100 100 100 100 100 100 100 100 100 100 100 100 100 100 100 100 100 100 100 100 100 100 100 100 100 100 100 100 100 100 100 100 100 100 100 100 100 100 100 100 100 100 100 100 100 100 100 100 100 100 100 100 100 100 100 100 100
100 100 100 100 100 100 100 100 100 100 100 100 100 100 100 100 100 100 100 100 100 100 100 100 100 100 100 100 100 100 100 100 100 100 100 100 100 100 100 100 100 100 100 100 100 100 100 100 100 100 100 100 100 100 100 100 100 100 100 100
100 100 100 100 100 100 100 100 100 100 100 100 100 100 100 100 100 100 100 146 147 148 100 100 100 100 146 147 148 100 100 100 100 100 100 146 147 148 100 100 100 100 100 100 100 100 100 100 100 100 100 100 100 100 100 100 100 100 100 100
100 100 100 100 100 100 100 100 100 100 137 138 139 100 155 156 157 158 100 149 150 151 100 100 100 100 149 150 151 100 100 100 100 100 100 149 150 151 100 100 100 100 100 100 100 100 100 100 100 100 100 100 100 100 100 100 100 100 100 100
100 100 100 100 100 100 100 100 100 100 140 141 142 100 159 160 161 162 100 152 153 154 100 100 100 100 152 153 154 100 100 100 100 100 100 152 153 154 100 100 100 100 100 100 100 100 100 100 100 100 100 100 100 100 100 100 100 100 100 100
100 100 100 100 100 100 100 100 100 100 143 144 145 100 100 100 100 100 100 100 100 100 100 100 100 100 100 100 100 100 100 100 100 100 100 100 100 100 100 100 100 100 100 100 100 100 100 100 100 100 100 100 100 100 100 100 100 100 100 100
100 100 100 100 100 100 100 100 100 100 100 100 100 100 100 100 100 100 100 100 100 100 100 100 100 100 100 100 100 100 100 100 100 100 100 100 100 100 100 100 100 100 100 100 100 100 100 100 100 100 100 100 100 100 100 100 100 100 100 100
100 100 100 100 100 100 100 100 100 100 100 100 100 100 100 100 137 138 139 100 100 100 100 146 147 148 100 155 156 157 158 100 146 147 148 100 100 100 146 147 148 100 100 137 138 139 100 100 100 137 138 139 100 100 100 100 100 100 100 100
100 100 100 100 100 100 100 100 100 100 100 100 100 100 100 100 140 141 142 100 100 100 100 149 150 151 100 159 160 161 162 100 149 150 151 100 100 100 149 150 151 100 100 140 141 142 100 100 100 140 141 142 100 100 100 100 100 100 100 100
100 100 100 100 100 100 100 100 137 138 139 100 100 100 100 100 143 144 145 100 100 100 100 152 153 154 100 100 100 100 100 100 152 153 154 100 100 100 152 153 154 100 100 143 144 145 100 100 100 143 144 145 100 100 100 100 100 100 100 100
100 100 100 100 100 100 100 100 140 141 142 100 100 100 100 100 100 100 100 100 100 100 100 100 100 100 100 100 100 100 100 100 100 100 100 100 100 100 100 100 100 100 100 100 100 100 100 100 100 100 100 100 100 100 100 100 100 100 100 100
100 100 100 100 100 100 100 100 143 144 145 100 100 100 100 100 100 100 100 100 100 100 100 100 100 100 100 100 100 100 100 100 100 100 100 100 100 100 100 100 100 100 100 100 100 100 100 100 100 100 100 100 100 100 100 100 100 100 100 100
100 100 100 100 100 100 100 100 100 100 100 100 116 116 116 116 116 116 116 116 116 116 116 116 116 116 116 116 118 119 116 116 116 116 116 116 116 116 116 116 116 116 116 116 116 116 116 116 100 100 100 100 100 100 100 100 100 100 100 100
100 100 100 100 100 100 155 156 157 158 100 100 117 100 100 100 100 100 100 100 100 100 100 100 100 100 100 100 100 100 100 100 100 100 100 100 100 100 100 100 100 100 100 100 100 100 100 117 100 100 137 138 139 100 100 100 100 100 100 100
100 100 100 100 100 100 159 160 161 162 100 100 117 100 133 134 100 100 100 133 134 100 100 100 133 134 100 100 100 100 108 100 155 156 157 158 100 114 100 114 100 114 100 114 100 114 100 117 100 100 140 141 142 100 100 100 100 100 100 100
100 100 100 100 100 100 100 100 100 100 100 100 117 100 135 136 100 100 100 135 136 100 100 100 135 136 100 100 100 100 109 100 159 160 161 162 100 115 100 115 100 115 100 115 100 115 100 117 100 100 143 144 145 100 100 100 100 100 100 100
100 100 100 100 100 100 100 100 137 138 139 100 117 100 100 100 100 100 100 100 100 100 100 100 100 100 100 100 100 100 100 100 100 100 100 100 100 100 100 100 100 100 100 100 100 100 100 117 100 100 100 100 100 100 100 100 100 100 100 100
100 100 100 100 100 100 100 100 140 141 142 100 117 100 100 167 167 167 167 167 167 167 167 167 167 167 167 167 167 167 167 167 167 167 167 167 167 167 167 167 167 167 100 100 100 100 100 117 100 100 100 100 100 137 138 139 100 100 100 100
100 100 100 100 100 100 100 100 143 144 145 100 117 100 100 167 100 100 100 100 100 100 100 100 100 100 100 100 100 100 100 100 100 100 100 100 100 100 100 100 100 167 100 100 100 105 100 117 100 100 100 100 100 140 141 142 100 100 100 100
100 100 100 100 100 100 100 100 100 100 100 100 117 100 100 167 100 100 100 100 164 100 105 100 100 164 100 100 100 100 100 100 100 100 123 124 100 100 108 100 100 167 100 100 100 100 100 117 100 100 100 100 100 143 144 145 100 100 100 100
100 100 100 100 100 100 100 100 100 100 100 100 117 106 100 167 120 100 100 100 100 100 100 100 100 100 100 100 100 106 100 100 100 100 100 100 100 100 109 100 100 167 100 100 100 100 100 117 100 100 100 100 100 100 100 100 100 100 100 100
100 100 100 100 100 100 100 100 100 100 100 100 117 107 100 167 100 100 100 100 100 110 111 110 111 110 111 100 100 107 100 100 100 100 100 100 100 100 100 100 100 167 100 100 108 100 100 117 100 100 100 100 100 100 100 100 100 100 100 100
100 100 100 100 100 100 100 100 100 100 100 100 117 100 100 167 100 100 100 100 100 112 113 112 113 112 113 100 100 100 100 100 108 100 100 100 100 100 100 100 100 167 100 100 109 100 100 117 100 100 100 100 100 100 100 100 100 100 100 100
100 100 100 100 100 100 100 100 137 138 139 100 117 100 100 167 100 106 100 106 121 101 101 101 101 101 101 122 100 164 100 100 109 100 100 100 100 100 100 100 100 167 100 100 100 100 100 117 100 100 137 138 139 100 100 100 100 100 100 100
100 100 100 100 100 100 100 100 140 141 142 100 117 100 100 167 100 107 100 107 105 101 101 101 101 101 101 105 100 100 100 100 100 100 100 100 100 100 100 100 100 167 100 100 100 100 100 117 100 100 140 141 142 100 100 100 100 100 100 100
100 100 100 100 100 100 100 100 143 144 145 100 117 100 100 167 100 100 100 100 114 101 101 101 101 101 101 114 100 100 100 100 100 100 100 100 106 100 100 164 100 167 100 120 100 100 100 117 100 100 143 144 145 100 100 100 100 100 100 100
100 100 100 100 100 100 100 100 100 100 100 100 117 108 100 167 100 100 100 100 115 101 101 101 101 101 101 115 100 100 100 100 100 100 100 100 107 100 100 100 100 167 100 100 100 100 100 117 100 100 100 100 100 100 100 100 100 100 100 100
100 100 100 100 100 100 100 100 100 100 100 100 117 109 100 167 100 100 100 100 105 101 101 101 101 101 101 105 100 100 100 100 100 100 100 100 100 100 100 100 100 167 100 100 164 100 100 117 100 100 100 100 100 100 100 100 100 100 100 100
100 100 100 100 100 100 155 156 157 158 100 100 117 100 100 167 100 164 100 100 121 101 101 102 101 101 101 122 100 100 125 126 127 128 100 100 100 100 100 100 100 167 100 100 100 100 100 117 100 100 100 100 100 100 100 100 100 100 100 100
100 100 100 100 100 100 159 160 161 162 100 100 117 100 100 167 100 100 100 100 100 103 103 104 103 103 103 100 100 100 129 130 131 132 100 100 100 100 100 100 100 167 100 100 100 100 100 117 100 100 146 147 148 100 100 100 100 100 100 100
100 100 100 100 100 100 100 100 100 100 100 100 117 100 100 167 100 100 100 100 100 103 103 104 103 103 103 100 100 100 100 100 100 100 100 100 100 100 164 100 100 167 100 165 100 100 105 117 100 100 149 150 151 100 100 100 100 100 100 100
100 100 100 100 100 100 100 100 100 100 100 100 117 100 100 167 100 100 100 100 100 100 100 167 120 100 100 100 163 100 100 100 100 105 100 100 100 100 100 100 100 167 100 166 100 100 100 117 100 100 152 153 154 100 100 100 100 100 100 100
100 100 100 100 100 100 100 100 100 100 100 100 117 105 100 167 100 100 105 100 100 100 100 167 100 100 100 100 100 100 108 100 100 100 100 100 100 100 100 100 100 167 100 100 100 100 100 117 100 100 100 100 100 100 100 100 100 100 100 100
100 100 100 100 100 100 100 100 100 100 100 100 117 100 100 167 100 100 100 106 100 165 100 167 100 106 100 165 100 100 109 100 100 100 100 108 100 100 100 100 100 167 100 100 164 100 100 117 100 100 100 100 100 100 100 100 100 100 100 100
100 100 100 100 100 100 100 100 137 138 139 100 117 100 100 167 100 100 100 107 100 166 100 167 100 107 100 166 100 100 100 100 100 100 100 109 100 100 100 100 100 167 100 100 100 100 100 117 100 100 100 100 100 137 138 139 100 100 100 100
100 100 100 100 100 100 100 100 140 141 142 100 117 100 100 167 100 100 100 100 100 100 100 167 100 100 100 100 100 100 100 100 100 100 100 100 100 100 100 106 100 167 100 100 100 100 100 117 100 100 100 100 100 140 141 142 100 100 100 100
100 100 100 100 100 100 100 100 143 144 145 100 117 100 100 167 108 100 100 100 100 100 100 167 100 100 100 100 164 100 100 100 105 100 100 100 100 100 100 107 100 167 100 100 100 100 100 117 100 100 100 100 100 143 144 145 100 100 100 100
100 100 100 100 100 100 100 100 100 100 100 100 117 100 100 167 109 100 100 100 100 108 100 167 100 100 100 100 100 106 100 100 100 100 100 100 100 100 100 100 100 167 100 100 100 100 100 117 100 100 100 100 100 100 100 100 100 100 100 100
100 100 100 100 100 100 100 100 100 100 100 100 117 165 100 167 100 100 100 100 100 109 100 167 100 100 100 100 100 107 100 100 100 100 100 100 100 120 100 100 100 167 100 100 108 100 164 117 100 100 100 100 100 100 100 100 100 100 100 100
100 100 100 100 100 100 155 156 157 158 100 100 117 166 100 167 100 100 100 100 100 100 100 167 100 108 100 100 100 100 100 100 100 100 105 100 100 100 100 100 100 167 100 100 109 100 100 117 100 100 100 100 100 100 100 100 100 100 100 100
100 100 100 100 100 100 159 160 161 162 100 100 117 100 100 167 100 100 100 100 100 100 100 167 100 109 100 100 100 100 100 100 100 100 100 100 100 100 100 100 100 167 100 100 100 100 100 117 100 100 137 138 139 100 100 100 100 100 100 100
100 100 100 100 100 100 100 100 100 100 100 100 117 100 100 167 120 100 100 100 100 100 100 167 100 100 100 100 100 100 100 100 100 100 100 100 100 100 100 100 100 167 100 100 100 100 100 117 100 100 140 141 142 100 100 100 100 100 100 100
100 100 100 100 100 100 100 100 100 100 100 100 117 100 100 167 167 167 167 167 167 167 167 167 167 167 167 167 167 167 167 167 167 167 167 167 167 167 167 167 167 167 100 100 123 124 100 117 100 100 143 144 145 100 100 100 100 100 100 100
100 100 100 100 100 100 100 100 137 138 139 100 117 100 105 100 100 100 100 100 100 100 100 100 100 100 100 100 100 100 100 100 100 100 100 100 100 100 100 100 100 100 100 100 100 100 100 117 100 100 100 100 100 100 100 100 100 100 100 100
100 100 100 100 100 100 100 100 140 141 142 100 117 100 100 100 100 100 100 100 100 100 100 108 100 100 100 100 100 100 100 100 100 100 108 100 100 100 100 100 100 120 100 100 100 100 100 117 100 100 100 100 100 137 138 139 100 100 100 100
100 100 100 100 100 100 100 100 143 144 145 100 117 100 123 124 100 100 155 156 157 158 100 109 100 100 108 100 100 100 100 100 100 100 109 100 100 105 100 100 100 100 100 100 100 120 100 117 100 100 100 100 100 140 141 142 100 100 100 100
100 100 100 100 100 100 100 100 100 100 100 100 117 100 100 100 100 100 159 160 161 162 100 100 100 100 109 100 100 100 100 100 100 100 100 100 100 100 100 100 100 100 100 100 100 100 100 117 100 100 100 100 100 143 144 145 100 100 100 100
100 100 100 100 100 100 100 100 100 100 100 100 116 116 116 116 116 116 116 116 116 116 116 116 116 116 116 116 118 119 116 116 116 116 116 116 116 116 116 116 116 116 116 116 116 116 116 116 100 100 100 100 100 100 100 100 100 100 100 100
100 100 100 100 100 100 100 100 100 100 100 100 100 100 100 100 100 100 100 100 100 100 100 100 100 100 100 100 100 100 100 100 100 100 100 100 100 100 100 100 100 100 100 100 100 100 100 100 100 100 100 100 100 100 100 100 100 100 100 100
100 100 100 100 100 100 100 100 100 100 100 100 100 100 100 100 100 100 100 100 100 100 100 100 100 100 100 100 100 100 100 100 100 100 100 100 100 100 100 100 100 100 100 100 100 100 100 100 100 100 100 100 100 100 100 100 100 100 100 100
100 100 100 100 100 100 100 100 100 100 100 100 100 100 100 100 100 100 100 100 100 100 100 100 100 100 100 100 100 100 100 100 100 100 100 100 100 100 100 100 100 100 100 100 100 100 100 100 100 100 100 100 100 100 100 100 100 100 100 100
100 100 100 100 100 100 100 100 137 138 139 100 100 100 137 138 139 100 100 100 137 138 139 100 100 100 137 138 139 100 100 137 138 139 100 100 100 100 137 138 139 100 100 100 137 138 139 100 100 100 137 138 139 100 100 100 100 100 100 100
100 100 100 100 100 100 100 100 140 141 142 100 100 100 140 141 142 100 100 100 140 141 142 100 100 100 140 141 142 100 100 140 141 142 100 100 100 100 140 141 142 100 100 100 140 141 142 100 100 100 140 141 142 100 100 100 100 100 100 100
100 100 100 100 100 100 100 100 143 144 145 100 100 100 143 144 145 100 100 100 143 144 145 100 100 100 143 144 145 100 100 143 144 145 100 100 100 100 143 144 145 100 100 100 143 144 145 100 100 100 143 144 145 100 100 100 100 100 100 100
100 100 100 100 100 100 100 100 100 100 100 100 100 100 100 100 100 100 100 100 100 100 100 100 100 100 100 100 100 100 100 100 100 100 100 100 100 100 100 100 100 100 100 100 100 100 100 100 100 100 100 100 100 100 100 100 100 100 100 100
100 100 100 100 100 100 100 100 100 100 100 100 100 100 100 100 100 100 100 100 100 100 100 155 156 157 158 100 100 100 100 100 100 100 155 156 157 158 100 100 100 100 100 100 100 100 100 100 100 100 100 100 100 100 100 100 100 100 100 100
100 100 100 100 100 100 100 100 100 100 100 100 100 100 100 100 100 100 100 100 100 100 100 159 160 161 162 100 100 100 100 100 100 100 159 160 161 162 100 100 100 100 100 100 100 100 100 100 100 100 100 100 100 100 100 100 100 100 100 100
100 100 100 100 100 100 100 100 100 100 100 100 100 100 100 100 100 100 100 100 100 100 100 100 100 100 100 100 100 100 100 100 100 100 100 100 100 100 100 100 100 100 100 100 100 100 100 100 100 100 100 100 100 100 100 100 100 100 100 100
100 100 100 100 100 100 100 100 100 100 100 100 100 100 100 100 100 100 100 100 100 100 100 100 100 100 100 100 100 100 100 100 100 100 100 100 100 100 100 100 100 100 100 100 100 100 100 100 100 100 100 100 100 100 100 100 100 100 100 100
100 100 100 100 100 100 100 100 100 100 100 100 100 100 100 100 100 100 100 100 100 100 100 100 100 100 100 100 100 100 100 100 100 100 100 100 100 100 100 100 100 100 100 100 100 100 100 100 100 100 100 100 100 100 100 100 100 100 100 100