91 91 91 91 91 91 91 91 91 91 91 91 91 91 91 91 91 91 91 91 91 91 91 91 91 91 91 91 91 91 91 91 91 91 91 91 91 91 91 91 91 91 91 91 91 91 91 91 91 91 91 91 91 91 91 91 91 91 91 91
91 91 91 91 91 91 91 91 91 91 91 91 91 91 91 91 91 91 91 91 91 91 91 91 91 91 91 91 91 91 91 91 91 91 91 91 91 91 91 91 91 91 91 91 91 91 91 91 91 91 91 91 91 91 91 91 91 91 91 91
91 91 91 91 91 91 91 91 91 91 91 91 91 91 91 91 91 91 91 91 91 91 91 91 91 91 91 91 91 91 91 91 91 91 91 91 91 91 91 91 91 91 91 91 91 91 91 91 91 91 91 91 91 91 91 91 91 91 91 91
91 91 91 91 91 91 91 91 91 91 91 91 91 91 91 91 91 91 91 91 91 91 91 91 91 91 91 91 91 91 91 91 91 91 91 91 91 91 91 91 91 91 91 91 91 91 91 91 91 91 91 91 91 91 91 91 91 91 91 91
91 91 91 91 91 91 91 91 91 91 91 91 91 91 91 91 91 91 91 91 91 91 91 91 91 91 91 91 91 91 91 91 91 91 91 91 91 91 91 91 91 91 91 91 91 91 91 91 91 91 91 91 91 91 91 91 91 91 91 91
91 91 91 91 91 91 91 91 91 91 91 91 91 91 91 91 91 91 91 91 91 91 91 91 91 91 91 91 91 91 91 91 91 91 91 91 91 91 91 91 91 91 91 91 91 91 91 91 91 91 91 91 91 91 91 91 91 91 91 91
91 91 91 91 91 91 91 91 91 91 91 91 91 91 91 91 91 91 91 91 91 91 91 91 91 91 91 91 91 91 91 91 91 91 91 91 91 91 91 91 91 91 91 91 91 91 91 91 91 91 91 91 91 91 91 91 91 91 91 91
91 91 91 91 91 91 91 91 91 91 91 91 91 91 91 91 91 91 91 91 91 91 91 91 91 91 91 91 91 91 91 91 91 91 91 91 91 91 91 91 91 91 91 91 91 91 91 91 91 91 91 91 91 91 91 91 91 91 91 91
91 91 91 91 91 91 91 91 91 91 91 91 91 91 91 91 91 91 91 91 91 91 91 91 91 91 91 91 91 91 91 91 91 91 91 91 91 91 91 91 91 91 91 91 91 91 91 91 91 91 91 91 91 91 91 91 91 91 91 91
91 91 91 91 91 91 91 91 91 91 91 91 91 91 91 91 91 91 91 91 91 91 91 91 91 91 91 91 91 91 91 91 91 91 91 91 91 91 91 91 91 91 91 91 91 91 91 91 91 91 91 91 91 91 91 91 91 91 91 91
91 91 91 91 91 91 91 91 91 91 91 91 91 91 91 91 91 91 91 91 91 91 91 91 91 91 91 91 91 91 91 91 91 91 91 91 91 91 91 91 91 91 91 91 91 91 91 91 91 91 91 91 91 91 91 91 91 91 91 91
91 91 91 91 91 91 91 91 91 91 91 91 91 91 91 91 91 91 91 91 91 91 91 91 91 91 91 91 91 91 91 91 91 91 91 91 91 91 91 91 91 91 91 91 91 91 91 91 91 91 91 91 91 91 91 91 91 91 91 91
91 91 91 91 91 91 91 91 91 91 91 91 55 55 55 55 55 55 82 83 84 55 82 83 84 55 82 83 84 55 55 55 82 83 84 55 55 55 55 82 83 84 55 55 82 83 84 55 91 91 91 91 91 91 91 91 91 91 91 91
91 91 91 91 91 91 91 91 91 91 91 91 55 66 67 68 55 55 85 86 87 55 85 86 87 55 85 86 87 55 60 55 85 86 87 55 55 55 55 85 86 87 55 60 85 86 87 55 91 91 91 91 91 91 91 91 91 91 91 91
91 91 91 91 91 91 91 91 91 91 91 91 55 69 95 96 55 55 88 89 90 55 88 89 90 55 88 89 90 55 55 55 88 89 90 55 60 55 55 88 89 90 55 55 88 89 90 55 91 91 91 91 91 91 91 91 91 91 91 91
91 91 91 91 91 91 91 91 91 91 91 91 55 97 98 99 55 55 55 55 55 55 55 55 55 55 55 55 55 92 55 55 55 55 55 55 55 55 55 55 55 55 55 55 55 55 55 55 91 91 91 91 91 91 91 91 91 91 91 91
91 91 91 91 91 91 91 91 91 91 91 91 55 93 55 56 56 56 56 56 56 56 56 56 56 56 56 56 56 56 56 56 56 56 56 56 56 56 56 56 56 56 56 56 56 55 55 55 91 91 91 91 91 91 91 91 91 91 91 91
91 91 91 91 91 91 91 91 91 91 91 91 55 94 55 56 55 55 55 55 55 55 55 55 55 55 55 55 55 55 61 55 55 55 55 55 55 55 82 83 84 55 55 55 56 55 61 55 91 91 91 91 91 91 91 91 91 91 91 91
91 91 91 91 91 91 91 91 91 91 91 91 55 55 61 56 55 55 55 55 55 55 55 55 55 55 55 55 55 55 55 55 55 55 55 60 55 55 85 86 87 55 55 55 56 55 55 55 91 91 91 91 91 91 91 91 91 91 91 91
91 91 91 91 91 91 91 91 91 91 91 91 60 55 55 56 55 55 55 61 55 55 55 55 55 55 60 55 55 55 55 55 60 55 55 55 55 55 88 89 90 55 55 55 56 60 55 55 91 91 91 91 91 91 91 91 91 91 91 91
91 91 91 91 91 91 91 91 91 91 91 91 55 55 55 56 55 55 55 55 55 55 55 91 91 91 91 91 91 91 91 91 91 91 55 55 55 55 55 92 55 55 55 55 56 55 55 55 91 91 91 91 91 91 91 91 91 91 91 91
91 91 91 91 91 91 91 91 91 91 91 91 55 55 55 56 55 55 55 55 55 60 55 91 91 91 91 91 91 91 91 91 91 91 55 55 55 55 55 55 55 55 55 55 56 55 55 55 91 91 91 91 91 91 91 91 91 91 91 91
91 91 91 91 91 91 91 91 91 91 91 91 55 61 55 56 55 55 55 55 55 55 55 91 91 62 63 64 65 62 63 64 91 91 55 92 55 61 55 55 55 55 60 55 56 55 60 55 91 91 91 91 91 91 91 91 91 91 91 91
91 91 91 91 91 91 91 91 91 91 91 91 55 55 55 56 55 55 55 92 55 93 55 91 91 55 55 55 56 55 55 55 91 91 55 55 55 55 55 55 55 55 55 55 56 55 55 55 91 91 91 91 91 91 91 91 91 91 91 91
91 91 91 91 91 91 91 91 91 91 91 91 55 55 55 56 55 55 55 55 55 94 60 91 91 55 55 55 56 55 55 55 91 91 55 55 55 55 55 55 55 55 55 55 56 60 55 55 91 91 91 91 91 91 91 91 91 91 91 91
91 91 91 91 91 91 91 91 91 91 91 91 60 55 55 56 55 55 76 77 55 55 55 91 91 55 55 55 56 55 55 55 91 91 55 55 76 77 55 55 76 77 55 55 56 55 55 55 91 91 91 91 91 91 91 91 91 91 91 91
91 91 91 91 91 91 91 91 91 91 91 91 55 55 55 56 55 55 78 79 55 55 55 91 91 55 55 55 56 55 55 55 91 91 55 55 78 79 55 55 78 79 55 55 56 55 55 55 91 91 91 91 91 91 91 91 91 91 91 91
91 91 91 91 91 91 91 91 91 91 91 91 55 55 55 56 55 55 55 55 55 55 55 91 91 55 55 55 56 55 55 55 91 91 55 55 55 55 55 55 55 55 55 55 56 55 61 55 91 91 91 91 91 91 91 91 91 91 91 91
91 91 91 91 91 91 91 91 91 91 91 91 55 61 55 56 55 55 55 55 55 55 55 91 91 55 55 55 56 55 55 55 91 91 55 60 55 55 55 55 55 55 55 55 56 55 55 55 91 91 91 91 91 91 91 91 91 91 91 91
91 91 91 91 91 91 91 91 91 91 91 91 55 55 55 56 55 55 55 60 55 55 55 91 91 55 55 55 56 55 55 55 91 91 55 55 55 55 60 55 55 55 55 55 56 55 55 55 91 91 91 91 91 91 91 91 91 91 91 91
91 91 91 91 91 91 91 91 91 91 91 91 55 55 55 56 55 55 55 55 55 55 55 91 91 55 55 55 56 55 55 55 91 91 55 92 55 55 55 55 55 55 55 55 56 55 55 55 91 91 91 91 91 91 91 91 91 91 91 91
91 91 91 91 91 91 91 91 91 91 91 91 55 55 55 56 55 55 55 55 55 55 60 91 91 57 57 57 58 57 57 57 91 91 55 55 55 55 55 55 55 92 55 55 56 55 55 55 91 91 91 91 91 91 91 91 91 91 91 91
91 91 91 91 91 91 91 91 91 91 91 91 55 55 55 56 55 55 76 77 55 55 55 91 91 91 91 91 59 91 91 91 91 91 55 55 55 55 55 55 55 55 55 55 56 55 55 61 91 91 91 91 91 91 91 91 91 91 91 91
91 91 91 91 91 91 91 91 91 91 91 91 55 55 55 56 55 55 78 79 55 55 55 91 91 91 91 91 59 91 91 91 91 91 55 55 55 55 55 55 55 55 55 55 56 55 55 55 91 91 91 91 91 91 91 91 91 91 91 91
91 91 91 91 91 91 91 91 91 91 91 91 55 55 61 56 55 55 55 55 55 55 55 55 55 55 55 55 56 55 55 55 55 55 55 55 55 61 55 55 55 55 61 55 56 55 55 55 91 91 91 91 91 91 91 91 91 91 91 91
91 91 91 91 91 91 91 91 91 91 91 91 60 55 55 56 55 55 55 55 55 61 55 70 71 72 55 55 56 60 55 70 71 72 55 55 55 55 55 55 55 55 55 55 56 55 61 55 91 91 91 91 91 91 91 91 91 91 91 91
91 91 91 91 91 91 91 91 91 91 91 91 55 55 55 56 55 55 55 55 55 55 55 73 74 75 55 55 56 55 55 73 74 75 55 55 55 55 55 55 55 55 55 55 56 55 55 55 91 91 91 91 91 91 91 91 91 91 91 91
91 91 91 91 91 91 91 91 91 91 91 91 55 55 55 56 55 82 83 84 55 55 55 55 56 55 55 55 56 55 55 55 56 55 55 55 55 55 55 82 83 84 55 55 56 60 55 55 91 91 91 91 91 91 91 91 91 91 91 91
91 91 91 91 91 91 91 91 91 91 91 91 55 55 55 56 55 85 86 87 55 55 55 55 56 56 56 56 56 56 56 56 56 55 55 55 55 55 55 85 86 87 55 55 56 55 55 55 91 91 91 91 91 91 91 91 91 91 91 91
91 91 91 91 91 91 91 91 91 91 91 91 55 55 61 56 55 88 89 90 55 55 55 55 55 55 55 55 56 55 55 55 55 55 55 61 55 55 55 88 89 90 55 55 56 55 55 55 91 91 91 91 91 91 91 91 91 91 91 91
91 91 91 91 91 91 91 91 91 91 91 91 55 55 55 56 55 55 55 55 55 55 55 61 55 55 55 55 56 55 55 55 55 55 55 55 55 55 55 55 55 55 55 55 56 55 55 55 91 91 91 91 91 91 91 91 91 91 91 91
91 91 91 91 91 91 91 91 91 91 91 91 55 55 55 56 55 55 55 55 55 55 55 55 55 55 55 55 56 55 55 55 55 55 55 55 55 55 55 55 55 55 55 55 56 55 55 55 91 91 91 91 91 91 91 91 91 91 91 91
91 91 91 91 91 91 91 91 91 91 91 91 55 55 55 56 56 56 56 56 56 56 56 56 56 56 56 56 56 56 56 56 56 56 56 56 56 56 56 56 56 56 56 56 56 61 55 55 91 91 91 91 91 91 91 91 91 91 91 91
91 91 91 91 91 91 91 91 91 91 91 91 55 55 55 55 55 55 55 55 55 55 55 55 55 55 55 55 55 55 55 55 55 55 55 55 92 55 55 55 55 55 55 55 55 55 55 55 91 91 91 91 91 91 91 91 91 91 91 91
91 91 91 91 91 91 91 91 91 91 91 91 55 61 55 55 55 55 55 55 55 55 60 55 55 55 55 55 55 55 61 55 55 55 55 55 55 55 55 55 55 55 55 55 55 55 55 60 91 91 91 91 91 91 91 91 91 91 91 91
91 91 91 91 91 91 91 91 91 91 91 91 55 55 55 55 55 55 60 55 55 55 55 55 55 55 55 55 55 55 55 55 55 60 55 61 55 55 55 55 55 55 55 55 61 55 55 55 91 91 91 91 91 91 91 91 91 91 91 91
91 91 91 91 91 91 91 91 91 91 91 91 55 55 55 55 55 55 55 55 55 55 55 55 55 55 55 61 55 55 55 55 55 55 55 55 55 55 55 55 60 55 55 55 55 55 55 55 91 91 91 91 91 91 91 91 91 91 91 91
91 91 91 91 91 91 91 91 91 91 91 91 57 57 57 57 57 57 57 57 57 57 57 57 57 57 57 57 57 57 57 57 57 57 57 57 57 57 57 57 57 57 57 57 57 57 57 57 91 91 91 91 91 91 91 91 91 91 91 91
91 91 91 91 91 91 91 91 91 91 91 91 91 91 91 91 91 91 91 91 91 91 91 91 91 91 91 91 91 91 91 91 91 91 91 91 91 91 91 91 91 91 91 91 91 91 91 91 91 91 91 91 91 91 91 91 91 91 91 91
91 91 91 91 91 91 91 91 91 91 91 91 91 91 91 91 91 91 91 91 91 91 91 91 91 91 91 91 91 91 91 91 91 91 91 91 91 91 91 91 91 91 91 91 91 91 91 91 91 91 91 91 91 91 91 91 91 91 91 91
91 91 91 91 91 91 91 91 91 91 91 91 91 91 91 91 91 91 91 91 91 91 91 91 91 91 91 91 91 91 91 91 91 91 91 91 91 91 91 91 91 91 91 91 91 91 91 91 91 91 91 91 91 91 91 91 91 91 91 91
91 91 91 91 91 91 91 91 91 91 91 91 91 91 91 91 91 91 91 91 91 91 91 91 91 91 91 91 91 91 91 91 91 91 91 91 91 91 91 91 91 91 91 91 91 91 91 91 91 91 91 91 91 91 91 91 91 91 91 91
91 91 91 91 91 91 91 91 91 91 91 91 91 91 91 91 91 91 91 91 91 91 91 91 91 91 91 91 91 91 91 91 91 91 91 91 91 91 91 91 91 91 91 91 91 91 91 91 91 91 91 91 91 91 91 91 91 91 91 91
91 91 91 91 91 91 91 91 91 91 91 91 91 91 91 91 91 91 91 91 91 91 91 91 91 91 91 91 91 91 91 91 91 91 91 91 91 91 91 91 91 91 91 91 91 91 91 91 91 91 91 91 91 91 91 91 91 91 91 91
91 91 91 91 91 91 91 91 91 91 91 91 91 91 91 91 91 91 91 91 91 91 91 91 91 91 91 91 91 91 91 91 91 91 91 91 91 91 91 91 91 91 91 91 91 91 91 91 91 91 91 91 91 91 91 91 91 91 91 91
91 91 91 91 91 91 91 91 91 91 91 91 91 91 91 91 91 91 91 91 91 91 91 91 91 91 91 91 91 91 91 91 91 91 91 91 91 91 91 91 91 91 91 91 91 91 91 91 91 91 91 91 91 91 91 91 91 91 91 91
91 91 91 91 91 91 91 91 91 91 91 91 91 91 91 91 91 91 91 91 91 91 91 91 91 91 91 91 91 91 91 91 91 91 91 91 91 91 91 91 91 91 91 91 91 91 91 91 91 91 91 91 91 91 91 91 91 91 91 91
91 91 91 91 91 91 91 91 91 91 91 91 91 91 91 91 91 91 91 91 91 91 91 91 91 91 91 91 91 91 91 91 91 91 91 91 91 91 91 91 91 91 91 91 91 91 91 91 91 91 91 91 91 91 91 91 91 91 91 91
91 91 91 91 91 91 91 91 91 91 91 91 91 91 91 91 91 91 91 91 91 91 91 91 91 91 91 91 91 91 91 91 91 91 91 91 91 91 91 91 91 91 91 91 91 91 91 91 91 91 91 91 91 91 91 91 91 91 91 91
91 91 91 91 91 91 91 91 91 91 91 91 91 91 91 91 91 91 91 91 91 91 91 91 91 91 91 91 91 91 91 91 91 91 91 91 91 91 91 91 91 91 91 91 91 91 91 91 91 91 91 91 91 91 91 91 91 91 91 91
