5 5 5 5 5 5 5 5 5 5 5 5 5 5 5 5 5 5 5 5 5 5 5 5 5 5 5 5 5 5 5 5 5 5 5 5 5 5 5 5 5 5 5 5 5 5 5 5 5 5 5 5 5 5 5 5 5 5 5 5
5 5 5 5 5 5 5 5 5 5 5 5 5 5 5 5 5 5 5 5 5 5 5 5 5 5 5 5 5 5 5 5 5 5 5 5 5 5 5 5 5 5 5 5 5 5 5 5 5 5 5 5 5 5 5 5 5 5 5 5
5 5 5 5 5 5 5 5 5 5 5 5 5 5 5 5 5 5 5 5 5 5 5 5 5 5 5 5 5 5 5 5 5 5 5 5 5 5 5 5 5 5 5 5 5 5 5 5 5 5 5 5 5 5 5 5 5 5 5 5
5 5 5 5 5 5 5 5 5 5 5 5 5 5 5 5 5 5 5 5 5 5 5 5 5 5 5 5 5 5 5 5 5 5 5 5 5 5 5 5 5 5 5 5 5 5 5 5 5 5 5 5 5 5 5 5 5 5 5 5
5 5 5 5 5 5 5 5 5 5 5 5 5 5 5 5 5 5 5 5 5 5 5 5 5 5 5 5 5 5 5 5 5 5 5 5 5 5 5 5 5 5 5 5 5 5 5 5 5 5 5 5 5 5 5 5 5 5 5 5
5 5 5 5 5 5 5 5 5 5 5 5 5 5 5 5 5 5 5 5 5 5 5 5 5 5 5 5 5 5 5 5 5 5 5 5 5 5 5 5 5 5 5 5 5 5 5 5 5 5 5 5 5 5 5 5 5 5 5 5
5 5 5 5 5 5 5 5 5 5 5 5 5 5 5 5 5 5 5 5 5 5 5 5 5 5 5 5 5 5 5 5 5 5 5 5 5 5 5 5 5 5 5 5 5 5 5 5 5 5 5 5 5 5 5 5 5 5 5 5
5 5 5 5 5 5 5 5 5 5 5 5 5 5 5 5 5 5 5 5 5 5 5 5 5 5 5 5 5 5 5 5 5 5 5 5 5 5 5 5 5 5 5 5 5 5 5 5 5 5 5 5 5 5 5 5 5 5 5 5
5 5 5 5 5 5 5 5 5 5 5 5 5 5 5 5 5 5 5 5 5 5 5 5 5 5 5 5 5 5 5 5 5 5 5 5 5 5 5 5 5 5 5 5 5 5 5 5 5 5 5 5 5 5 5 5 5 5 5 5
5 5 5 5 5 5 5 5 5 5 5 5 5 5 5 5 5 5 5 5 5 5 5 5 5 5 5 5 5 5 5 5 5 5 5 5 5 5 5 5 5 5 5 5 5 5 5 5 5 5 5 5 5 5 5 5 5 5 5 5
5 5 5 5 5 5 5 5 5 5 5 11 7 7 7 7 7 7 7 7 7 7 7 7 7 7 7 7 7 7 7 7 7 7 7 7 7 7 7 7 7 7 7 7 7 7 7 7 12 5 5 5 5 5 5 5 5 5 5 5
5 5 5 5 5 5 5 5 5 5 5 10 9 9 21 22 8 9 9 4 8 8 31 32 33 8 8 4 8 9 8 4 8 9 8 31 32 33 9 4 8 9 9 9 4 8 9 9 10 5 5 5 5 5 5 5 5 5 5 5
5 5 5 5 5 5 5 5 5 5 5 10 9 14 8 8 14 4 4 14 8 4 34 35 36 4 8 14 8 14 4 14 4 4 9 34 35 36 8 40 8 40 8 40 4 8 8 8 10 5 5 5 5 5 5 5 5 5 5 5
5 5 5 5 5 5 5 5 5 5 5 10 8 15 4 9 15 9 4 15 9 8 37 38 39 4 4 15 9 15 9 15 8 4 4 37 38 39 9 41 8 41 9 41 8 9 8 9 10 5 5 5 5 5 5 5 5 5 5 5
5 5 5 5 5 5 5 5 5 5 5 10 9 27 9 8 27 8 8 27 8 4 4 4 8 8 4 29 8 30 8 29 9 4 8 9 9 4 8 9 8 4 8 9 4 4 4 8 10 5 5 5 5 5 5 5 5 5 5 5
5 5 5 5 5 5 5 5 5 5 5 10 4 28 9 9 28 8 8 28 9 4 8 9 8 9 9 29 8 30 8 29 9 4 4 21 22 8 9 9 4 8 9 8 9 9 4 8 10 5 5 5 5 5 5 5 5 5 5 5
5 5 5 5 5 5 5 5 5 5 5 10 4 3 3 3 3 3 3 3 3 3 3 3 3 3 3 3 4 9 9 9 8 9 4 8 8 4 8 8 8 4 8 9 4 8 9 9 10 5 5 5 5 5 5 5 5 5 5 5
5 5 5 5 5 5 5 5 5 5 5 10 9 3 8 13 9 13 9 13 9 13 9 4 8 4 4 3 9 8 25 4 13 9 13 9 13 9 13 9 8 9 4 8 8 4 8 8 10 5 5 5 5 5 5 5 5 5 5 5
5 5 5 5 5 5 5 5 5 5 5 10 4 3 9 29 4 30 8 29 8 30 8 9 4 9 9 3 3 3 26 9 30 8 29 8 30 8 29 8 4 8 9 4 9 9 9 9 10 5 5 5 5 5 5 5 5 5 5 5
5 5 5 5 5 5 5 5 5 5 5 10 9 3 8 9 9 8 8 4 9 4 8 4 8 9 4 8 9 3 3 3 3 3 3 3 3 3 3 3 3 3 3 3 3 3 9 9 10 5 5 5 5 5 5 5 5 5 5 5
5 5 5 5 5 5 5 5 5 5 5 10 8 3 4 8 4 9 9 4 8 9 4 8 4 8 4 8 9 3 8 9 8 8 8 4 8 9 9 4 8 9 9 9 9 3 8 9 10 5 5 5 5 5 5 5 5 5 5 5
5 5 5 5 5 5 5 5 5 5 5 10 9 3 9 4 16 17 4 8 16 17 4 8 8 8 4 8 4 3 4 4 8 9 4 9 9 4 8 9 9 4 8 8 8 3 4 8 10 5 5 5 5 5 5 5 5 5 5 5
5 5 5 5 5 5 5 5 5 5 5 10 4 3 9 9 18 19 9 8 18 19 4 8 1 2 0 1 1 3 1 0 0 0 0 8 8 9 13 9 13 8 13 8 8 3 4 8 10 5 5 5 5 5 5 5 5 5 5 5
5 5 5 5 5 5 5 5 5 5 5 10 9 3 4 8 8 9 8 9 9 9 8 4 1 0 0 2 0 3 1 2 0 2 1 8 8 4 27 4 27 9 27 4 4 3 9 9 10 5 5 5 5 5 5 5 5 5 5 5
5 5 5 5 5 5 5 5 5 5 5 10 9 3 3 3 3 3 3 3 3 4 4 8 1 1 0 2 0 3 0 0 1 1 1 8 8 4 28 4 28 4 28 9 4 3 9 9 10 5 5 5 5 5 5 5 5 5 5 5
5 5 5 5 5 5 5 5 5 5 5 10 9 3 4 4 8 4 9 8 3 9 8 4 0 2 0 3 3 3 3 3 2 0 2 9 8 8 4 4 4 9 4 9 4 3 9 9 10 5 5 5 5 5 5 5 5 5 5 5
5 5 5 5 5 5 5 5 5 5 5 10 4 3 8 9 51 52 8 8 3 8 9 4 0 1 1 3 3 3 3 3 1 2 1 8 9 4 8 8 4 8 9 8 8 3 4 8 10 5 5 5 5 5 5 5 5 5 5 5
5 5 5 5 5 5 5 5 5 5 5 10 4 3 9 8 53 54 9 8 3 3 3 3 3 3 3 3 3 3 3 3 3 3 3 3 3 3 3 3 3 3 3 3 3 3 4 8 10 5 5 5 5 5 5 5 5 5 5 5
5 5 5 5 5 5 5 5 5 5 5 10 9 3 8 20 8 4 20 8 9 9 8 4 1 1 1 3 3 3 3 3 1 0 0 8 23 9 4 8 8 4 8 9 4 3 9 9 10 5 5 5 5 5 5 5 5 5 5 5
5 5 5 5 5 5 5 5 5 5 5 10 8 3 9 29 9 8 30 8 8 9 9 9 1 1 2 3 3 3 3 3 0 2 0 9 24 9 4 4 9 9 4 8 8 3 8 8 10 5 5 5 5 5 5 5 5 5 5 5
5 5 5 5 5 5 5 5 5 5 5 10 8 3 8 4 8 8 8 8 9 9 8 8 2 0 0 1 1 3 0 0 2 1 1 8 9 4 8 4 4 8 9 4 9 3 9 9 10 5 5 5 5 5 5 5 5 5 5 5
5 5 5 5 5 5 5 5 5 5 5 10 8 3 9 8 9 9 9 4 8 8 9 9 1 1 1 2 0 3 2 1 1 1 1 9 9 20 8 20 4 20 8 20 4 3 4 8 10 5 5 5 5 5 5 5 5 5 5 5
5 5 5 5 5 5 5 5 5 5 5 10 9 3 9 9 8 9 9 4 9 9 8 8 4 8 9 9 4 3 9 9 8 4 8 9 9 29 8 30 4 29 9 30 4 3 9 9 10 5 5 5 5 5 5 5 5 5 5 5
5 5 5 5 5 5 5 5 5 5 5 10 4 3 8 8 9 4 8 4 8 9 9 9 4 8 9 8 4 3 9 8 8 4 25 9 8 8 9 4 8 4 8 4 9 3 8 9 10 5 5 5 5 5 5 5 5 5 5 5
5 5 5 5 5 5 5 5 5 5 5 10 8 3 4 8 8 4 4 8 4 8 4 9 9 4 8 9 9 3 8 4 8 8 26 4 8 20 8 20 9 20 8 20 4 3 4 8 10 5 5 5 5 5 5 5 5 5 5 5
5 5 5 5 5 5 5 5 5 5 5 10 9 3 4 4 4 4 8 9 4 4 9 8 8 8 4 8 8 3 3 3 3 3 8 9 9 29 9 30 9 29 8 30 8 3 9 9 10 5 5 5 5 5 5 5 5 5 5 5
5 5 5 5 5 5 5 5 5 5 5 10 4 3 9 20 8 20 9 20 4 8 8 4 8 42 43 44 9 8 8 4 4 3 4 8 8 8 4 8 4 8 8 4 4 3 4 8 10 5 5 5 5 5 5 5 5 5 5 5
5 5 5 5 5 5 5 5 5 5 5 10 8 3 4 29 4 30 8 29 8 4 8 4 8 45 46 47 8 23 9 4 4 3 4 4 9 20 9 20 8 20 4 20 8 3 8 4 10 5 5 5 5 5 5 5 5 5 5 5
5 5 5 5 5 5 5 5 5 5 5 10 8 3 9 4 8 8 8 9 8 9 9 9 4 48 49 50 4 24 8 4 9 3 8 4 4 30 9 29 9 30 8 29 4 3 9 9 10 5 5 5 5 5 5 5 5 5 5 5
5 5 5 5 5 5 5 5 5 5 5 10 8 3 8 20 9 20 9 20 8 8 8 8 8 4 8 9 4 8 9 8 8 3 8 4 8 9 8 8 4 9 4 4 8 3 4 8 10 5 5 5 5 5 5 5 5 5 5 5
5 5 5 5 5 5 5 5 5 5 5 10 8 3 8 30 9 29 4 30 4 4 3 3 3 3 3 3 3 3 3 3 3 3 3 3 3 3 3 3 3 3 3 3 3 3 9 4 10 5 5 5 5 5 5 5 5 5 5 5
5 5 5 5 5 5 5 5 5 5 5 10 4 3 8 4 8 8 4 8 8 9 3 9 4 8 9 9 8 9 4 9 8 9 8 9 9 9 4 4 4 8 4 8 8 8 9 9 10 5 5 5 5 5 5 5 5 5 5 5
5 5 5 5 5 5 5 5 5 5 5 10 4 3 3 3 3 3 3 3 3 3 3 9 4 8 9 8 4 8 9 4 4 8 8 4 8 8 8 8 4 4 8 9 8 8 9 4 10 5 5 5 5 5 5 5 5 5 5 5
5 5 5 5 5 5 5 5 5 5 5 11 7 7 7 7 7 7 8 4 4 4 8 9 9 8 9 4 8 4 8 8 8 9 9 9 9 9 8 8 8 4 7 7 7 7 7 7 12 5 5 5 5 5 5 5 5 5 5 5
5 5 5 5 5 5 5 5 5 5 5 6 6 6 6 6 6 6 7 7 7 7 8 4 4 8 9 9 4 4 8 9 4 4 8 8 8 7 7 7 7 7 6 6 6 6 6 6 6 5 5 5 5 5 5 5 5 5 5 5
5 5 5 5 5 5 5 5 5 5 5 5 5 5 5 5 5 5 6 6 6 6 7 7 7 7 7 7 7 7 7 7 7 7 7 7 7 6 6 6 6 6 5 5 5 5 5 5 5 5 5 5 5 5 5 5 5 5 5 5
5 5 5 5 5 5 5 5 5 5 5 5 5 5 5 5 5 5 5 5 5 5 6 6 6 6 6 6 6 6 6 6 6 6 6 6 6 5 5 5 5 5 5 5 5 5 5 5 5 5 5 5 5 5 5 5 5 5 5 5
5 5 5 5 5 5 5 5 5 5 5 5 5 5 5 5 5 5 5 5 5 5 5 5 5 5 5 5 5 5 5 5 5 5 5 5 5 5 5 5 5 5 5 5 5 5 5 5 5 5 5 5 5 5 5 5 5 5 5 5
5 5 5 5 5 5 5 5 5 5 5 5 5 5 5 5 5 5 5 5 5 5 5 5 5 5 5 5 5 5 5 5 5 5 5 5 5 5 5 5 5 5 5 5 5 5 5 5 5 5 5 5 5 5 5 5 5 5 5 5
5 5 5 5 5 5 5 5 5 5 5 5 5 5 5 5 5 5 5 5 5 5 5 5 5 5 5 5 5 5 5 5 5 5 5 5 5 5 5 5 5 5 5 5 5 5 5 5 5 5 5 5 5 5 5 5 5 5 5 5
5 5 5 5 5 5 5 5 5 5 5 5 5 5 5 5 5 5 5 5 5 5 5 5 5 5 5 5 5 5 5 5 5 5 5 5 5 5 5 5 5 5 5 5 5 5 5 5 5 5 5 5 5 5 5 5 5 5 5 5
5 5 5 5 5 5 5 5 5 5 5 5 5 5 5 5 5 5 5 5 5 5 5 5 5 5 5 5 5 5 5 5 5 5 5 5 5 5 5 5 5 5 5 5 5 5 5 5 5 5 5 5 5 5 5 5 5 5 5 5
5 5 5 5 5 5 5 5 5 5 5 5 5 5 5 5 5 5 5 5 5 5 5 5 5 5 5 5 5 5 5 5 5 5 5 5 5 5 5 5 5 5 5 5 5 5 5 5 5 5 5 5 5 5 5 5 5 5 5 5
5 5 5 5 5 5 5 5 5 5 5 5 5 5 5 5 5 5 5 5 5 5 5 5 5 5 5 5 5 5 5 5 5 5 5 5 5 5 5 5 5 5 5 5 5 5 5 5 5 5 5 5 5 5 5 5 5 5 5 5
5 5 5 5 5 5 5 5 5 5 5 5 5 5 5 5 5 5 5 5 5 5 5 5 5 5 5 5 5 5 5 5 5 5 5 5 5 5 5 5 5 5 5 5 5 5 5 5 5 5 5 5 5 5 5 5 5 5 5 5
5 5 5 5 5 5 5 5 5 5 5 5 5 5 5 5 5 5 5 5 5 5 5 5 5 5 5 5 5 5 5 5 5 5 5 5 5 5 5 5 5 5 5 5 5 5 5 5 5 5 5 5 5 5 5 5 5 5 5 5
5 5 5 5 5 5 5 5 5 5 5 5 5 5 5 5 5 5 5 5 5 5 5 5 5 5 5 5 5 5 5 5 5 5 5 5 5 5 5 5 5 5 5 5 5 5 5 5 5 5 5 5 5 5 5 5 5 5 5 5
5 5 5 5 5 5 5 5 5 5 5 5 5 5 5 5 5 5 5 5 5 5 5 5 5 5 5 5 5 5 5 5 5 5 5 5 5 5 5 5 5 5 5 5 5 5 5 5 5 5 5 5 5 5 5 5 5 5 5 5
5 5 5 5 5 5 5 5 5 5 5 5 5 5 5 5 5 5 5 5 5 5 5 5 5 5 5 5 5 5 5 5 5 5 5 5 5 5 5 5 5 5 5 5 5 5 5 5 5 5 5 5 5 5 5 5 5 5 5 5
5 5 5 5 5 5 5 5 5 5 5 5 5 5 5 5 5 5 5 5 5 5 5 5 5 5 5 5 5 5 5 5 5 5 5 5 5 5 5 5 5 5 5 5 5 5 5 5 5 5 5 5 5 5 5 5 5 5 5 5